1111111111111
1C0C0C0C00001
1P0C0C0000011
1001000010011
11000C0000C11
11C0011000EC1
